10 20
1111111111
1110000111
1100000011
1000000001
1100000011
1110000111
1111001111
1111001111
1001001001
1009009001
1001001001
1111001111
1001001001
1004009001
1001001001
1111001111
1111001111
1110000111
1110000111
1111111111