10 10
1111111111
3000010002
3000000002
3000000002
3000000002
3100000012
3000000002
3000000002
3000010002
1111111111