57 42
111111111122221333333331222222211111111111111111111111111
100000000100001000000001000000010000000000000000000000001
100000000400001000000001000000010000000000000000000000001
100000000100004000000001000000010000000000000000000000001
100000000100001000000004000000040000000000000000000000001
100000000100001000000001000000010000000000000000000000001
100000000100001000000001000000010000000000000000000000001
100000000100001000000001000000010000000000000000000000001
100000000100001000000001000000010000000000000000000000001
100000000100001000000001000000001111111911111110000000001
100000000100001000000001000000000000000000000001000000001
100000000100001000000004000000000000000000000009000000001
100000000100001000000001000000000000000000000001000000001
100000000100001000000001000000000000000000000001000000001
100000000100001000000001000000000000000000000001000000001
100000000100001000000001000000000000000000000004000000001
100000000100001000000001000000000000000000000001000000001
100000000019910000000000111114111111111111911110000000001
100000000000000000000000000000000000000000000000000000001
100000000000000000000000000000000000000000000000000000001
100000000000000000000000000000000000000000000000000000001
100000000000000000000000000000000000000000000000000000001
100000000000000000000000000000000000000000000000000000001
100000000000000000000000000000000000000000000000000000001
100000000000000000000000000000000000000000000000000000001
166666996666660000000000111911100000000001111111911111111
500000000000001000000001000000010000000015555555055555552
500000000000001000000004000000010000000010000000000000502
500000000000001000000001000000010000000010000000000000502
500000000000001000000001000000010000000040000000000000502
500000000000004000000001000000010000000010000000000000502
500000000000001000000001000000010000000010000000000000502
500000000000001000000001000000010000000015555555555555502
500000000000001000000001000000010000000011111111111111141
500000000000001000000001000000010000000000000000000000003
500000000000001000000001000000010000000000000000000000003
500000000000004000000001000000010000000000000000000000003
500000000000001000000001000000040000000000000000000000003
500000000000001000000001000000010000000000000000000000003
500000000000001000000004000000010000000000000000000000003
500000000000001000000001000000010000000000000000000000003
122222222222221333333331222222211111111111111111111111111