10 10
1111111111
1000000001
1000000001
1000000001
1100000001
1000000011
1000000001
1000000001
1000000001
1112111121