5 5
11111
10001
10101
10501
11121
