10 10
1111111111
1000000001
1000000002
1000000003
1000000001
1000000001
1000000001
1000000001
1000000001
1111111111