10 10
1111111111
1000010001
1111411112
1000000003
1000000001
1100000011
1000010001
1000090001
1000010001
1111111111