10 20
1111111111
1110000111
1100000011
1000000001
1100000011
1110000111
1111001111
1221001221
2001001002
2009009002
2001001002
1221001221
2001001002
2004009002
2001001002
1211001111
1111001111
1130000311
1130000311
1112222111